

NO /Users/ybouchra/Desktop/cub3d_42/srcs/textures/Brick/Brick_01-128x128.png
SO /Users/ybouchra/Desktop/cub3d_42/srcs/textures/Brick/Brick_01-128x128.png
WE /Users/ybouchra/Desktop/cub3d_42/srcs/textures/Brick/Brick_01-128x128.png
EA /Users/ybouchra/Desktop/cub3d_42/srcs/textures/Brick/Brick_01-128x128.png

F 220,100,000
C +11,000,1





11111111111111111111111111
1000000000000000000000000
1001000000000000000000001
11111111011000001110000000000001
100000000011000001110111111111111
11110111111110P11NWSE1000111111000000
1111011111111101110101010001
1100000011010101110000010001
10000000000000110000001001
10000000000000001101010010001
1100000111010101111101111000111
11110111 1110101 101111010001
11111111 1111111 111111111111
10001111
100001111




111111111
1
1