NO /Users/ybouchra/Desktop/cub3d_42/srcs/textures/Brick/Brick_01-128x128.png
SO /Users/ybouchra/Desktop/cub3d_42/srcs/textures/Brick/Brick_01-128x128.png
WE /Users/ybouchra/Desktop/cub3d_42/srcs/textures/Brick/Brick_01-128x128.png
EA /Users/ybouchra/Desktop/cub3d_42/srcs/textures/Brick/Brick_01-128x128.png




F 220,100,000
C +11,000,1

     
        
111111111111111111111111
11111111111111111111111111111111111111
111111111111111111111100001
1010000000000111111111110001
101000000000001  10000000011
101000000000001  100111111
101000000000001  1011111
1010S000000001  10011111
110000000000001  10010011
111111111111111111111111
    